########## ##########
#........###........#
#...P....|.|........#
#........###........#
########## #####|####
               #.#
               #.#
               #.#
               #.#
               #.#
               #.#
               #.#
################.###############################################################
#..............................................................................#
#..............................................................................#
#..............................................................................#
#..............................................................................#
#..............................................................................#
#..............................................................................#
#..............................................................................#
#..............................................................................#
################################################################################